   ##########################
#  #         ####           #
#  #         #    #   # ### #
#  ###########  ###       # #
#                 #  ##   #*#
#############################
